{
        "tile_mappings": {
                "-1": "transparent",
                 "1": "carpet"
        },
        
        "gate_mappings": {
                "D": [[0,0],[16,7]]
        },

        "background_layers": {},

        "foreground_layers": {},

        "chunks_map": {
                "0,0": [["-1","0","0","0","0","0","0","0","0","0","0","0","0","0","-1"],
                        ["-1","0","0","0","0","0","0","0","0","0","0","0","0","0","-1"],
                        ["-1","0","0","0","0","0","0","0","0","0","0","0","0","0","-1"],
                        ["-1","0","0","0","0","0","0","0","0","0","0","0","0","0","-1"],
                        ["-1","0","0","0","0","0","0","0","0","0","0","0","0","0","-1"],
                        ["-1","0","0","0","0","0","0","0","0","0","0","0","0","0","-1"],
                        ["-1","0","0","0","0","0","0","0","0","0","0","0","0","0","-1"],
                        ["-1","0","0","0","0","0","0","0","0","0","0","0","0","0","-1"],
                        ["-1","0","0","0","0","0","0","0","0","0","0","0","0","0","-1"],
                        ["1","1","1","1","1","1","1","1","1","1","1","1","1","1","1"]]
        },

        "objects_map": {
                "0,0": [["0","0","0","0","0","0","0","0","0","0","0","0","0","0","0"],
                        ["0","0","0","0","0","0","0","0","0","0","0","0","0","0","0"],
                        ["0","0","0","0","0","0","0","0","0","0","0","0","0","0","0"],
                        ["0","0","0","0","0","0","0","0","0","0","0","0","0","0","0"],
                        ["0","0","0","0","0","0","0","0","0","0","0","0","0","0","0"],
                        ["0","0","0","0","0","0","0","0","0","0","0","0","0","0","0"],
                        ["0","0","0","0","0","0","0","0","0","0","0","0","0","0","0"],
                        ["0","0","0","0","0","0","0","0","0","0","0","0","0","0","0"],
                        ["0","0","0","0","0","0","0","0","0","0","0","0","0","0","0"],
                        ["0","0","0","0","0","0","0","0","0","0","0","0","0","0","0"]]
        },

        "background_map": {
                "0,0": [["0","0","0","0","0","0","0","0","0","0","0","0","0","0","0"],
                        ["0","0","0","0","0","0","0","0","0","0","0","0","0","0","0"],
                        ["0","0","0","0","0","0","0","0","0","0","0","0","0","0","0"],
                        ["0","0","0","0","0","0","0","0","0","0","0","0","0","0","0"],
                        ["0","0","0","0","0","0","0","0","0","0","0","0","0","0","0"],
                        ["0","0","0","0","0","0","0","0","0","0","0","0","0","0","0"],
                        ["0","0","0","0","0","0","0","0","0","0","0","0","0","0","0"],
                        ["0","0","0","0","0","0","0","0","0","0","0","0","0","0","0"],
                        ["0","0","0","0","0","0","0","0","0","0","0","0","0","0","0"],
                        ["0","0","0","0","0","0","0","0","0","0","0","0","0","0","0"]]
        }

}
