{
        "tile_mappings": {
                "-1": "transparent",
                 "1": "grass",
                 "2": "entrance_black",
                 "c1": "cave1",
                 "c2": "cave2",
                 "c4": "cave4",
                 "c5": "cave5",
                 "c9": "cave9",
                 "c10": "cave10",
                 "c17": "cave17",
                 "c18": "cave18",
                 "c19": "cave19",
                 "c20": "cave20",
                 "c25": "cave25",
                 "c26": "cave26",
                 "c33": "cave33"
        },
        
        "gate_mappings": {
                "A": [[6,0],[11,7]]
        },

        "background_layers": {
                "layer_1": ["grass_layer1",0],
                "layer_2": ["grass_layer2",0.05],
                "layer_3": ["grass_layer3",0.2],
                "layer_4": ["grass_layer4",0.7],
                "layer_5": ["grass_layer5",0.8]
        },

        "foreground_layers": {},

        "chunks_map": {
                "0,0": [["-1","0","0","0","0","0","0","0","0","0","0","0","0","0","0"],
                        ["-1","0","0","0","0","0","0","0","0","0","0","0","0","0","0"],
                        ["-1","0","0","0","0","0","0","0","0","0","0","0","0","0","0"],
                        ["-1","0","0","0","0","0","0","0","0","0","0","0","0","0","0"],
                        ["-1","0","0","0","0","0","0","0","0","0","0","0","0","0","0"],
                        ["-1","0","0","0","0","0","0","0","0","0","0","0","0","0","0"],
                        ["-1","0","0","0","0","0","0","0","0","0","0","0","0","0","0"],
                        ["-1","0","0","0","0","0","0","0","0","0","0","0","0","0","0"],
                        ["-1","0","0","0","0","0","0","0","0","0","0","0","0","0","0"],
                        ["1","1","1","1","1","1","1","1","1","1","1","1","1","1","1"]],
                
                "1,0": [["0","0","0","0","0","0","0","0","0","0","0","0","0","0","0"],
                        ["0","0","0","0","0","0","0","0","0","0","0","0","0","0","0"],
                        ["0","0","0","0","0","0","0","0","0","0","0","0","0","0","0"],
                        ["0","0","0","0","0","0","0","0","0","0","0","0","0","0","0"],
                        ["0","0","0","0","0","0","0","0","0","0","0","0","0","0","0"],
                        ["0","0","0","0","0","0","0","0","0","0","0","0","0","0","0"],
                        ["0","0","0","0","0","0","0","0","0","0","0","0","0","0","0"],
                        ["0","0","0","0","0","0","0","0","0","0","0","0","0","0","0"],
                        ["0","0","0","0","0","0","0","0","0","0","0","0","0","0","0"],
                        ["1","1","1","1","1","1","1","1","1","1","1","1","1","1","1"]],
                
                "2,0": [["0","0","0","0","0","0","0","0","0","0","0","0","0","0","0"],
                        ["0","0","0","0","0","0","0","0","0","0","0","0","0","0","0"],
                        ["0","0","0","0","0","0","0","0","0","0","0","0","0","0","0"],
                        ["0","0","0","0","0","0","0","0","0","0","0","0","0","0","0"],
                        ["0","0","0","0","0","0","0","0","0","0","0","0","0","0","0"],
                        ["0","0","0","0","0","0","0","0","0","0","0","0","0","0","0"],
                        ["0","0","0","0","0","0","0","0","0","0","0","0","0","0","0"],
                        ["0","0","0","0","0","0","0","0","0","0","0","0","0","0","0"],
                        ["0","0","0","0","0","0","0","0","0","0","0","0","0","0","0"],
                        ["1","1","1","1","1","1","1","1","1","1","1","1","1","1","1"]],

                "3,0": [["0","0","0","0","0","0","0","0","0","0","0","0","0","0","0"],
                        ["0","0","0","0","0","0","0","0","0","0","0","0","0","0","0"],
                        ["0","0","0","0","0","0","0","0","0","0","0","0","0","0","0"],
                        ["0","0","0","0","0","0","0","0","0","0","0","0","0","0","0"],
                        ["0","0","0","0","0","0","0","0","0","0","0","0","0","0","0"],
                        ["0","0","0","0","0","0","0","0","0","0","0","0","0","0","0"],
                        ["0","0","0","0","0","0","0","0","0","0","0","0","0","0","0"],
                        ["0","0","0","0","0","0","0","0","0","0","0","0","0","0","0"],
                        ["0","0","0","0","0","0","0","0","0","0","0","0","0","0","0"],
                        ["1","1","1","1","1","1","1","1","1","1","1","1","1","1","1"]],
        
                "4,0": [["0","0","0","0","0","0","0","0","0","0","0","0","0","0","0"],
                        ["0","0","0","0","0","0","0","0","0","0","0","0","0","0","0"],
                        ["0","0","0","0","0","0","0","0","0","0","0","0","0","0","0"],
                        ["0","0","0","0","0","0","0","0","0","0","0","0","0","0","0"],
                        ["0","0","0","0","0","0","0","0","0","0","0","0","0","0","0"],
                        ["0","0","0","0","0","0","0","0","0","0","0","0","0","0","0"],
                        ["0","0","0","0","0","0","0","0","0","0","0","0","0","0","0"],
                        ["0","0","0","0","0","0","0","0","0","0","0","0","0","0","0"],
                        ["0","0","0","0","0","0","0","0","0","0","0","0","0","0","0"],
                        ["1","1","1","1","1","1","1","1","1","1","1","1","1","1","1"]],
                        
                "5,0": [["0","0","0","0","0","0","0","0","0","0","0","0","0","0","0"],
                        ["0","0","0","0","0","0","0","0","0","0","0","0","0","0","0"],
                        ["0","0","0","0","0","0","0","0","0","0","0","0","0","0","0"],
                        ["0","0","0","0","0","0","0","0","0","0","0","0","0","0","0"],
                        ["0","0","0","0","0","0","0","0","0","0","0","0","0","0","0"],
                        ["0","0","0","0","0","0","0","0","0","0","0","0","0","0","0"],
                        ["0","0","0","0","0","0","0","0","0","0","0","0","0","0","0"],
                        ["0","0","0","0","0","0","0","0","0","0","0","0","0","0","0"],
                        ["0","0","0","0","0","0","0","0","0","0","0","0","0","0","0"],
                        ["1","1","1","1","1","1","1","1","1","1","1","1","1","1","1"]],

                "6,0": [["0","0","0","0","0","0","0","0","c9","c10","c10","c10","c10","c10","c10"],
                        ["0","0","0","0","0","0","0","0","c9","c10","c10","c10","c10","c10","c10"],
                        ["0","0","0","0","0","0","0","0","c9","c10","c10","c10","c10","c10","c10"],
                        ["0","0","0","0","0","0","0","0","c9","c10","c10","c10","c10","c10","c10"],
                        ["0","0","0","0","0","0","0","0","c9","c4","c18","c18","c18","c5","c10"],
                        ["0","0","0","0","0","0","0","0","c17","c19","0","0","0","c17","c5"],
                        ["0","0","0","0","0","0","0","0","0","0","0","0","0","0","c9"],
                        ["0","0","0","0","0","0","0","0","0","0","0","0","0","0","c9"],
                        ["0","0","0","0","0","0","0","0","0","0","0","0","0","0","c9"],
                        ["1","1","1","1","1","1","c1","c2","c2","c2","c2","c2","c2","c2","c2"]]
        },

        "objects_map": {
                "0,0": [["0","0","0","0","0","0","0","0","0","0","0","0","0","0","0"],
                        ["0","0","0","0","0","0","0","0","0","0","0","0","0","0","0"],
                        ["0","0","0","0","0","0","0","0","0","0","0","0","0","0","0"],
                        ["0","0","0","0","0","0","0","0","0","0","0","0","0","0","0"],
                        ["0","0","0","0","0","0","0","0","0","0","0","0","0","0","0"],
                        ["0","0","0","0","0","0","0","0","0","0","0","0","0","0","0"],
                        ["0","0","0","0","0","0","0","0","0","0","0","0","0","0","0"],
                        ["0","0","0","0","0","0","0","0","0","0","0","0","0","0","0"],
                        ["0","0","0","0","0","0","0","0","0","0","0","0","0","0","0"],
                        ["0","0","0","0","0","0","0","0","0","0","0","0","0","0","0"]],

                "2,0": [["0","0","0","0","0","0","0","0","0","0","0","0","0","0","0"],
                        ["0","0","0","0","0","0","0","0","0","0","0","0","0","0","0"],
                        ["0","0","0","0","0","0","0","0","0","0","0","0","0","0","0"],
                        ["0","0","0","0","0","0","0","0","0","0","0","0","0","0","0"],
                        ["0","0","0","0","0","0","0","0","0","0","0","0","0","0","0"],
                        ["0","0","0","0","0","0","0","0","0","0","0","0","0","0","0"],
                        ["0","0","0","0","0","0","0","0","0","0","0","0","0","0","0"],
                        ["0","0","0","0","0","0","0","0","0","0","0","0","0","0","0"],
                        ["0","0","0","0","0","0","0","E:Lion","0","0","0","0","0","0","0"],
                        ["0","0","0","0","0","0","0","0","0","0","0","0","0","0","0"]],
                
                "3,0": [["0","0","0","0","0","0","0","0","0","0","0","0","0","0","0"],
                        ["0","0","0","0","0","0","0","0","0","0","0","0","0","0","0"],
                        ["0","0","0","0","0","0","0","0","0","0","0","0","0","0","0"],
                        ["0","0","0","0","0","0","0","0","0","0","0","0","0","0","0"],
                        ["0","0","0","0","0","0","0","E:Bird","0","0","0","0","0","0","0"],
                        ["0","0","0","0","0","0","0","0","0","0","0","0","0","0","0"],
                        ["0","0","0","0","0","0","0","0","0","0","0","0","0","0","0"],
                        ["0","0","0","0","0","0","0","0","0","0","0","0","0","0","0"],
                        ["0","0","0","0","0","0","0","0","0","0","0","0","0","0","0"],
                        ["0","0","0","0","0","0","0","0","0","0","0","0","0","0","0"]],
                
                "5,0": [["0","0","0","0","0","0","0","0","0","0","0","0","0","0","0"],
                        ["0","0","0","0","0","0","0","0","0","0","0","0","0","0","0"],
                        ["0","0","0","0","0","0","0","0","0","0","0","0","0","0","0"],
                        ["0","0","0","0","0","0","0","0","0","0","0","0","0","0","0"],
                        ["0","0","0","0","0","0","0","0","E:Bird","0","0","0","0","0","0"],
                        ["0","0","0","0","0","0","0","0","0","0","0","0","0","0","0"],
                        ["0","0","0","0","0","0","0","0","0","0","0","0","0","0","0"],
                        ["0","0","0","0","0","0","0","0","0","0","0","0","0","0","0"],
                        ["E:Lion","0","0","0","0","0","0","0","0","0","0","0","0","0","0"],
                        ["0","0","0","0","0","0","0","0","0","0","0","0","0","0","0"]],

                "6,0": [["0","0","0","0","0","0","0","0","0","0","0","0","0","0","0"],
                        ["0","0","0","0","0","0","0","0","0","0","0","0","0","0","0"],
                        ["0","0","0","0","0","0","0","0","0","0","0","0","0","0","0"],
                        ["0","0","0","0","0","0","0","0","0","0","0","0","0","0","0"],
                        ["0","0","0","0","0","0","0","0","0","0","0","0","0","0","0"],
                        ["0","0","0","0","0","0","0","0","0","0","0","0","0","0","0"],
                        ["0","0","0","0","0","0","0","0","0","0","0","0","0","0","0"],
                        ["0","0","0","0","0","0","0","0","0","0","0","G:1-2A","0","0","0"],
                        ["0","E:Lion","0","0","0","0","0","0","0","0","0","G:1-2A","0","0","0"],
                        ["0","0","0","0","0","0","0","0","0","0","0","0","0","0","0"]]
        },

        "background_map": {
                "6,0": [["0","0","0","0","0","0","0","0","0","0","0","0","0","0","0"],
                        ["0","0","0","0","0","0","0","0","0","0","0","0","0","0","0"],
                        ["0","0","0","0","0","0","0","0","0","0","0","0","0","0","0"],
                        ["0","0","0","0","0","0","0","0","0","0","0","0","0","0","0"],
                        ["0","0","0","0","0","0","0","0","0","0","0","0","0","0","0"],
                        ["0","0","0","0","0","0","0","0","0","0","c26","c10","c26","0","0"],
                        ["0","0","0","0","0","0","0","0","c25","c26","2","0","0","c26","0"],
                        ["0","0","0","0","0","0","0","0","c25","c33","0","0","0","c33","0"],
                        ["0","0","0","0","0","0","0","c20","c33","c26","0","0","0","c26","0"],
                        ["0","0","0","0","0","0","0","0","0","0","0","0","0","0","0"]]
        }
        
}
